+---------+
|          
| +---+ +-+
|     | | |
+-----+ + |
|     |   |
| +-+ +-+ |
| | + | | |
| |   | | |
+ +-+ + + |
    |     |
+---+-----+
| amaze-1 |
+---+-----+
